4 4 4 4 4 4 4 4 4 4 4 4 4 4 4 4
4 0 0 0 0 0 0 0 0 0 0 0 0 0 0 4
4 0 0 0 0 0 0 0 0 0 0 0 0 0 0 4
4 0 0 0 0 1 1 3 1 1 3 0 0 0 0 4
4 0 0 0 1 3 5 5 5 1 1 0 0 0 0 4
4 0 0 0 1 5 5 5 5 5 1 0 0 0 0 4
4 0 0 0 3 5 5 5 5 5 3 0 0 0 0 4
4 0 0 0 1 1 5 5 5 1 1 0 0 0 0 4
4 0 0 0 0 3 1 3 1 3 0 0 0 0 0 4
4 0 0 0 0 0 0 0 0 0 0 0 0 0 0 4
4 0 0 0 0 0 0 0 0 0 0 0 0 0 0 4
4 4 4 4 4 4 4 4 4 4 4 4 4 4 4 4